#########
#       #
#       ####
## #### #  #
## #@##    #
# ooo o  oo#
#  # ## o  #
#  # ##  o ####
####  ooo o#  #
 #   ##   ....#
 # #   # #.. .#
 #   # # ##...#
 ##### o  #...#
     ##   #####
      #####