 ###  #############
##@####       #   #
# oo   oo  o o ...#
#  ooo#    o  #...#
# o   # oo oo #...#
###   #  o    #...#
#     # o o o #...#
#    ###### ###...#
## #  #  o o  #...#
#  ## # oo o o##..#
# ..# #  o      #.#
# ..# # ooo ooo #.#
##### #       # #.#
    # ######### #.#
    #           #.#
    ###############