####
#  ##############
#  #   ..#......#
#  # # ##### ...#
##o#    ........#
#   ##o######  ####
# o #     ######@ #
##o # o   ######  #
#  o #ooo##       #
#      #    #o#o###
# #### #ooooo    #
# #    o     #   #
# #   ##        ###
# ######o###### o #
#        #    #   #
##########    #####